Morford	Mark P. O.
Wright	Richard Bruce
D'Este	Carlo
Kolata	Gina Bari
Barber	E. J. W.
Tan	Amy
Cowley	Robert
Turow	Scott
Cordingly	David
Beattie	Ann
Richards	David Adams
Lebor	Adam
Heti	Sheila
Kaiser	R. J.
Canfield	Jack
Estleman	Loren D.
Hendrickson	Robert
Oliver	Julia
Grisham	John
Morrison	Toni
Onion	The
Brown	Celia Brooks
Parrish	J. R.
Olsen	Mary-Kate Ashley
Clairday	Robynn
Duey	Kathleen
Shapero	Rich
Crichton	Michael
CRICHTON	MICHAEL
Lewis	C.S.
PHILLIPS	ARTHUR
Jaramillo	Stephan
Richler	Mordecai
Cooney	Eleanor
Link	Charlotte
Patterson	Richard North
Salzman	Mark
Lee	Harper
HILLENBRAND	LAURA
Kingsolver	Barbara
Dereske	Jo
Austen	Jane
Krieger	Dolores
Siddons	Anne Rivers
Koontz	Dean R.
Clark	Mary Higgins
Koontz	Dean
Cornwell	Patricia
Robb	J.D.
Binchy	Maeve
Mixon	Laura J.
Lahaye	Tim
GRISHAM	JOHN
Siegel	M.D. Bernie S.
Warren	Robert Penn
Hoefer	Hans Johannes
Helprin	Mark
Md	O. Carol Simonton
Hill	Chuck
Iglehart	David
McMurtry	Larry
STAPLES	SUZANNE FISHER
Tournier	Michel
Sagan	Carl
Zinoviev	Aleksandr
Tyler	Anne
Conrad	Joseph
Chopra	Deepak
Hardy	Thomas
Noland	Charles
Frankel	Valerie
Hoff	Benjamin
Machiavelli	Niccolo
Brown	H. Jackson
Heinlein	Robert A.
PULLMAN	PHILIP
Sewell	Anna
ONDAATJE	MICHAEL
Ceren	Sandra Levy
O'Rourke	P.J.
Gayle	Mike
Pavlou	Stel
Stuart	Sarah Payne
Quayle	Dan
Kettl	Donald F.
FRUM	DAVID
Lamour	Louis
Salinger	J.D.
Tolkien	J. R. R.
Berendt	John
Crusie	Jennifer
Heller	Jane
Rips	Michael
Mawer	Simon
Abrahams	William
Kiyosaki	Robert T.
Follett	Ken
Love	John F.
Allen	Robert G.
BERNIERES	LOUIS DE
Proctor	Pam
Albom	Mitch
Frei	Irene Gonzalez
Friedman	Michael Jan
Swarthout	Glendon
Jr.	Neal Barrett
Morrell	David
Brown	Sandra
Patterson	James
Woods	Stuart
JOHANSEN	IRIS
Brown	Dan
Hutsko	Joe
Shreve	Anita
Rule	Ann
GRIZZARD	LEWIS
Theroux	Paul
Grizzard	Lewis
Hickey	Charles
King	Stephen
Mezrich	Ben
Hand	Bill
Clancy	Tom
REEVE	DANA
Metzger	Barbara
Marquez	Gabriel Garcia
Wells	Rebecca
Hillerman	Tony
Waller	Robert James
Harris	Rachel
MCEWAN	IAN
Lewis	Michael
Zimler	Richard
Jetmundsen	Norman
Carcaterra	Lorenzo
Frasier	Anne
Hooper	Kay
Kierkegaard	Soren
Gaset	Jose Ortega Y
Maurier	Daphne Du
Hawthorne	Nathaniel
Page	Nick
Wolf	Laura
DUNCAN	LOIS
Grant	Susan
Vine	Barbara
Murphy	Shirley Rousseau
Lindskold	Jane
Smith	Betty
Shepherd	Cybill
O'Nan	Stewart
Baldacci	David
Adams	Douglas
Lawson	Mary
Cather	Willa
Goldsmith	Olivia
Fielding	Helen
Dixon	Franklin W.
Braun	Lilian Jackson
Virden	Holly
Wright	H. Norman
Anthony	Piers
BRADBURY	RAY
Austen	Mary
Bradbury	Ray
Chandler	Raymond
Coelho	Paolo
Weldon	Fay
Weir	Arabella
Davenport	Kiana
Townsend	Sue
Demirkan	Renan
Moore	Michael
Franzen	Jonathan
Salinger	Jerome D.
Joyce	James
Trollope	Joanna
Kundera	Milan
Roy	Arundhati
Levinson	Robert S.
Landvik	Lorna
Golden	Arthur
HARUF	KENT
Cornwell	Patricia D.
Farley	Carol J.
Woodiwiss	Kathleen E.
Plain	Belva
HADDON	MARK
BRASHARES	ANN
Segal	Erich
Adler	Elizabeth
Sparks	Nicholas
SAUL	JOHN
LANDVIK	LORNA
Thayer	Steve
Chevalier	Tracy
Kelman	Judith
Palmer	Michael
Hughes	Francine
Bridwell	Norman
McCourt	Frank
McCourt	Malachy
Sandoz	Mari
Perry	Anne
SMITH	ALEXANDER MCCALL
Maguire	Gregory
Martel	Yann
Rendell	Ruth
Franken	Al
TARTT	DONNA
Milne	John
Pratchett	Terry
White	E. B.
Barrie	J. M.
O'Hara	Mary
Rennison	Louise
Grahame	Kenneth
Cornwell	Bernard
Lint	Charles de
Dunsany	Edward John Moreton Drax Plunkett
Heyer	Georgette
WILDE	OSCAR
Hughes	Ted
DAHL	ROALD
Napoli	Donna Jo
Byatt	A. S.
Hidier	Tanuja Desai
KINSELLA	SOPHIE
Wolff	Isabel
Alcott	Louisa May
Orwell	George
Dickens	Charles
Allende	Isabel
Datlow	Ellen
BYATT	A.S.
Heller	Joseph
Galsworthy	John
Blyton	Enid
Gaiman	Neil
Moore	Alan
Suggs	Trudy
Wolfe	Tom
Udall	Brady
Hickam	Homer
Abraham	Pearl
Junger	Sebastian
Armstrong	Karen
Barnard	Mary
Brin	David
Boyle	T. Coraghessan
Woodruff	Paul
Madaras	Lynda
McCauley	Stephen
Holland	Isabelle
Conrad	Pam
McDaniel	Lurlene
Kaufman	Brian
Darnton	John
Schenk	Martin
EDDINGS	DAVID
Reiser	Paul
Hartwell	David G.
Barry	Dave
Holt	John R.
Beale	Theodore
Robinson	Frank M.
Clark	Mary Jane
Shelley	Mary Wollstonecraft
Simau1999	Isabel-Clara
Westall	Robert
Parker	Robert B.
Works	Rita Chapman
Ansay	A. Manette
Waters	Sarah
Frank	Anne
Lopez	Barry
Palast	Greg
Kane	Andrea
Barr	Nevada
Auster	Paul
Maron	Margaret
BARKER	EDNA
Whitaker	Muriel
Irving	John
Patchett	Ann
Dahl	Roald
Kidd	Sue Monk
Thiele	Bob
McCullough	Colleen
Harris	Joanne
Cahill	Thomas
Hudson	Michael
Smiley	Jane
Francis	Dick
Roberts	Nora
Marzollo	Jean
Wick	Walter
Delinsky	Barbara
James	P. D.
Upfield	Arthur William
Rice	Christopher
Stout	Rex
Anderson	Joan
Havner	Vance
Wiersbe	Warren W.
Lucado	Max
Crabb	Lawrence J
Kaufman	Barry Neil
Sjogren	Bob
Moody	Frederick J.
Pirolo	Neal
Sleator	William
Saint-Exupauy	Antoine de
Bach	Richard
Sullivan	Kevin
Morgan	Michele
Cunningham	Scott,
Hulse	David Allen
Webster	Richard
King	Bernard
Hutchins	Pat
Shakespeare	William
McClone	Melissa
John	Cheryl St.
Carroll	Lewis
Twain	Mark
Crow	Dog Mary
Gordon	Linda
King	Florence
Sebold	Alice
Gray	Spalding
Harris	Thomas
RUTHERFURD	EDWARD
Atwood	Margaret
Allison	Dorothy
ANGELOU	MAYA
Wharton	Edith
Bird	Mary Brave
Neihardt	John G.
Warren	Roland
Molloy	Johnny
McCourt	James
Wurtzel	Elizabeth
Bradley	Bill
Ruiz	Don Miguel
Racionero	Luis
Simau	Eugeni Perea
Hauser	Thomas
Villatoro	Vicenau
Mora	Vauctor
Castedo	Elena
Dracs	Ofaulia
Serra	Antoni
Junyent	M. Carme
Capau1987	Jaume
Serra	Maurius
Torrent	Ferran
Agut	Joan
Rico-Godoy	Carmen
Jaau	Maria
Lester	Paul
Tolstoy	Leo
Nye	Simon
Johnson	Robert A
Vazquez-Rial	Horacio
Gascoigne	Marc
Maze	Stephanie
Dallas	Sandra
McCaffrey	Anne
Gemmell	David
Zigman	Laura
Truman	Margaret
Kynaston	Nic
Danziger	Paula
Lupoff	Richard A.
Bebris	Carrie
Dubois	Ellen Carol
Ransom	Candice F.
Bobrick	Sam
Grosvenor	Donna K
HAWTHORNE	NATHANIEL
Block	Valerie
Rice	Luanne
Gilchrist	Ellen
IRVING	JOHN
GAUTREAUX	TIM
Russo	Richard
Gaarder	Jostein
QUINDLEN	ANNA
Johnson	Diane
KOONTZ	DEAN
Lamb	Wally
Mah	Adeline Yen
Ehrenreich	Barbara
DUNNETT	DOROTHY
CARRE	JOHN LE
Gordon	A. C.
Dickinson	Emily
Harrison	Hazel
Girzone	Joseph
GIRZONE	JOSEPH
Anderson	Lorraine
HUDLER	AD
Carlton	Josephine
Nancy	Ted L.
Wheen	Francis
Reardon	Joyce
Sheldon	Sidney
Moore	Christopher
Lacey	Robert
Dorsey	Tim
COMPTON	JODI
Leonard	Elmore
Coady	Lynn
Lawton	John
Lo	Eileen Yin-Fei
Edwards	Tilden H.
Seth	Vikram
Gaskell	Elizabeth
Diamant	Anita
Haney	Lauren
Stern	Gerald
Cornwell	Patricia Daniels
Grimes	Martha
James	Henry
Jewett	Sarah Orne
Williams	William Carlos
Trollope	Anthony
Kemelman	Harry
Millington	Mil
Farnham	Suzanne G.
Milosz	Czeslaw
Guenther	Margaret
Juarroz	Roberto
Rubinstein	Akiba
McLaughlin	Emma
Coelho	P
Ferrante	Elena
Jennings	Paul
Neely	Mark E., Jr.
Weininger	Stephen J.
Katzenstein	Larry
Steinman	David
Kohn	Alfie
Lillard	Paula Polk
Lewis	David
Livingston	Billie
Lang	Adele
Banbury	Jen
Coulter	Catherine
Dunne	Dominick
Cussler	Clive
Pascal	John
Hiaasen	Carl
Foer	Jonathan Safran
Marciano	Francesca
GLASS	JULIA
O'Dell	Tawni
Weiner	Jennifer
Steel	Danielle
Hale	Leon
Banks	Russell
Coleridge	Samuel Taylor
Warshauer	Bradley
Mason	Bobbie Ann
Robards	Karen
Lathen	Emma
Kellerman	Faye
Mitchard	Jacquelyn
SMILEY	JANE
DAVIDSON	DIANE MOTT
Bushnell	Candace
HANNAH	KRISTIN
Marshall	Michael
Widome	Allen
Smith	Wilbur
Thaler	Mike
Slade	Michael
Sandford	John
HOAG	TAMI
Dekker	Ted
Hunt	Angela Elwell
Lewis	C. S.
Eisner	William
Cook	Robin
HARRIS	E. LYNN
Goodman	Linda
RICE	ANNE
Rice	Anne
Rossner	Judith
French	Marilyn
Dyer	Wayne W.
Maupin	Armistead
Morgenstern	Julie
Straub	Peter
Bradford	Barbara Taylor
Jackson	Lisa
MCCRUMB	SHARYN
Roberts	Cokie
Corey	Shana
Ostrow	Jesse S.
Korman	Justine
GIFF	PATRICIA REILLY
Cleary	Beverly
Applegate	K. A.
Yolen	Jane
Moche	Dinah L.
Miller	Marvin
Boldman	Craig
Wells	H. G.
Kalman	Bobbie
Lackey	Mercedes
Gilman	Dorothy
Finch	Christopher
FRAZIER	CHARLES
Spencer-Fleming	Julia
Flagg	Fannie
Wilder	Laura Ingall
GARDNER	LISA
Warner	Gertrude Chandler
Hightower	Lynn S.
McCrumb	Sharyn
Schlosser	Eric
Brockmann	Suzanne
Levine	Gail Carson
KUFFEL	FRANCES
Conant	Susan
SCHICKLER	DAVID
McNaught	Judith
Evanovich	Janet
Plath	Sylvia
Koidahl	Ilona
Michaels	Fern
Byars	Betsy
Sterling	Bruce
Breathnach	Sarah Ban
Hoffman	Alice
Scottoline	Lisa
Johnson	Spencer
McEwan	Ian
Feldman	David
Bausch	Richard
Fforde	Katie
Burke	James
Broyard	Bliss
Paretsky	Sara
Webb	Charles
Benedict	Elizabeth
Morison	Stanley
Miller	Henry
Whyte	David
Bennis	Warren
Beck	Martha
Tutu	Desmond Mpilo
Shepard	Kris
Kerouac	Jack
Buber	Martin
Bettin	Gianfranco
Monette	Paul
Hemingway	Ernest
Carlson	Melody
Kwitney	Alisa
Letts	Billie
Bank	Melissa
Gelissen	Rena Kornreich
Zappa	Moon Unit
Mooney	Ted
Wiggs	Susan
Rubio	Gwyn Hyman
Robinson	Elisabeth
Niffenegger	Audrey
Farrington	Tim
Potok	Chaim
Spencer	Scott
Naipaul	V. S.
Naipaul	V.S.
Giono	Jean
Fournier	Alain
Remarque	Erich Maria
Barjavel	Rene
David-Neiel	Alexandra
Baudelaire	C.
Radiguet	Raymond
Zola	Emile
Nadolny	Sten
Benard	Cheryl
Wichterich	Christa
Blofeld	John.
Obbo	Christine
Heim	Peter B
Lind	Hera
Hamilton	Jane
Higgins	Jack
Collins	Max Allan
Guterson	David
Schlink	Bernhard
Dickey	Eric Jerome
Gaffney	Patricia
Evans	Richard Paul
Levy	Marc
Becker	Laney Katz
NABOKOV	VLADIMIR
Lauck	Jennifer
Keenan	Joe
Ray	Jeanne
Parsons	Tony
McCafferty	Jane
Esquivel	Laura
TOLKIEN	J.R.R.
Berry	Venise T.
Karon	Jan
McCarthy	Cormac
Thrasher	Travis
McEnroe	John
Mandel	Sally
Shuler	Linda Lay
Dailey	Janet
Lanzmann	Claude
Snicket	Lemony
Thomas	Matthew
Vian	Boris
Sepeilveda	Luis
Selby	Hubert
Weisberg	Jacob
Lodge	David
Hamilton	Judy
Ardagh	Philip
Banks	Iain
Crombie	David
Steinbeck	John
O'Mara	Michael
Brassey	Richard
Hamme	Jean Van
Holder	R. W.
Ferguson	Valerie
Werber	Bernard
Sloss	Andy
KRONZEK	ALLAN ZOLA
Squire	Charles L.
Jarvie	Gordon
Spence	Alan
Siegel	Helene
Shepard	E.H.
Milne	Alan Alexander
Thompson	Eric
Strout	Elizabeth
Sedaris	David
Feinberg	Leslie
Wolfe	Chris Anne
Sanders	Lauren
Baudino	Gael
Maddison	Lauren
Anshaw	Carol
Stewart	Jean
Donoghue	Emma
McDowell	Deborah
Tulchinsky	Karen X.
Thompson	Jill
Seay	Jody
Scott	Manda
Foxworthy	Jeff
Brooks	Terry
Crispin	A.C.
Crispin	A. C.
Arnold	Madelyn
Pierce	Tamora
Chute	Carolyn
Orwig	Sara
Michaels	Melisa
Bird	Isobel
Pohl	Frederik
MCINTYRE	VONDA
Varley	John
Garden	Nancy
Griffith	Nicola
Campbell	Julie
SMITH	LEE
WOODSON	JACQUELINE
Woodson	Jacqueline
Summitt	Pat Head
Belzer	Richard
Hornby	Nick
Johnson	Andrew L.
Babson	Marian
Gear	W. Michael
Phifer	Paul
Hoeg	Peter
Bombeck	Erma
Vecchioni	Roberto
Mortimer	John
Doctorow	E. L.
Schama	Simon
Waters	Frank
Hesse	Karen
Oppel	Kenneth
Brink	Carol Ryrie
Roberts	Shelly R.
Duane	Diane
Brockmann	Carolee
Roberts	Rachel
Namioka	Lensey
Behrend	Jackie Eileen
Clements	Andrew
LOWRY	LOIS
Hattaway	Paul
Stella	Alain
Moser	Milena
Highsmith	Patricia
Donaldson	Stephen
DONALDSON	STEPHEN R.
Rimbauer	Ellen
Herzog	Todd
Borneman	John
MCELVAINE	ROBERT S.
Stoker	Bram
Stackpole	Michael A.
Hughes	Langston
Matthews	Carol
Matthews	Carole
Tobin	Jacqueline L.
Bradley	Marion Zimmer
Codrescu	Andrei
Aarsen	Carolyne
L'Amour	Louis
Chapman	Jack
Alessandra	Anthony J
Swindoll	Charles R.
Card	Orson Scott
Howard	V. A
Wilson	Walter P.
Fries	Bruce
Limbaugh	Rush H., III
Dingus	Anne
Chopin	Kate
Kazanjian	Kirk
Allen	Donald Merriam
Maples	William
Hausman	Carl
Peck	Richard
Connelly	Michael
Lescroart	John T.
Jakes	John
McDermott	Alice
Bailey	Hilary
Fast	Howard
Fletcher	Jessica
PATTERSON	RICHARD NORTH
Goudge	Eileen
STEEL	DANIELLE
Lamb	Arnette
CRONKITE	WALTER
Mula	Tom
Dyer	Lois Faye
Lamb	Sharon
Doyle	Sir Arthur Conan
CHRISTIE	AGATHA
Cohen	Mark
Shahan	Sherry
Myers	Helen
Rowland	Della
Adler	Irving.
Peters	Elizabeth
Busbee	Shirlee
BRONTE	EMILY
Peretti	Frank E.
Keel	John A.
Scott	Stefanie
Winters	Rebecca
Cabot	Meg
Lee	Tanith
Thacker	Cathy Gillen
Burton	Richard
Eugenides	Jeffrey
Hastings	Beverly
Bergerac	Cyrano de
Robertson	James C.
Southwick	Teresa
Guest	Judith
Field	Sandra
Brooks	Helen
Wright	Blanche Fisher
Gately	George
Burke	James Lee
Chabon	Michael
Michaels	Barbara
Juster	Norton
Blake	Michael
Bellairs	John
HIAASEN	CARL
Douglas	Carole Nelson
GOLDMAN	WILLIAM
Reisner	Marc
Bowden	Mark
Pearce	Jonathan
Bronte	Emily
Botton	Alain de
Palahniuk	Chuck
Proulx	Annie
Davies	Adam
Walker	Harry M.
Evans	Nicholas
MONTGOMERY	L.M.
MITCHELL	DAVID
Bukowski	Charles
Murakami	Haruki
Burnett	Frances Hodgson
Wrede	Patricia C.
London	Jack
Wilkinson	Bruce
Goodway	Malcolm
MacDonald	Ann-Marie
Johansen	Iris
MICHAELS	FERN
Howard	Linda
Miller	Sue
Tepper	Sheri S.
SEUSS	DR
Wolff	Tobias
Singer	Isaac Bashevis
Zukav	Gary
Kelly	Alfred H.
Kliban	B
BLUNT	JUDY
Trevor	William
Walker	Alice
Gazi	Stephen
Stegner	Wallace
DeLillo	Don
Ellison	Ralph
Silverstein	Shel
Lahiri	Jhumpa
Trigg	Liz
Sullivan	Charles
ROBBINS	TOM
Hegi	Ursula
Richardson	Samuel
Martin	Valerie
Farrer-Halls	Gill
Mordock	John
Bowes	Susan
GABALDON	DIANA
Smith	Zadie
GOLDBERG	NATALIE
Grafton	Sue
Kennedy	William J.
Shacochis	Bob
Alcorn	Randy
Cobb	Nancy
Moor	Margriet de
Carnegie	Dale
Stoll	Clifford
CISNEROS	SANDRA
Paulsen	Gary
Henry	Marguerite
Garland	Sherry
Kirberger	Kimberly
Papa	Ariella
Rosen	Michael J.
Chipman	Dawn
Olson	Shannon
Naylor	Phyllis Reynolds
Stolz	Karen
NAYLOR	CLARE
Chbosky	Stephen
Albanese	Antonio
Weis	Margaret
Doig	Ivan
Nasar	Sylvia
Jin	Ha
Laird	Elizabeth
Ellison	Harlan
Gitlitz	David M.
Hohlbein	Wolfgang
Hein	Christoph
Hauptmann	Gaby
See	Carolyn
Wolf	Christa
Brussig	Thomas
Vitebsky	Piers
Weidner	Christopher
Lovecraft	H. P.
Grim	Pamela
Clarke	Arthur C.
Bennett	Jay
Applegate	John
Straczynski	J. Michael
Myers	John Myers
Tannahill	Reay
Whyte	Jack
Donaldson	Stephen R.
Donaldson	Stephen R
Matthiessen	Peter
Kent	Paul
McKinley	Robin
Whittemore	Hank
Satter	Ellyn
Brittain	Bill
Wilson	August
Robinson	Marilynn
Nunez	Sigrid
Scott	Amanda
Fowles	John
Catling	Christopher
Bundles	A'Lelia
Sayers	Dorothy L.
Deveraux	Jude
Lindbergh	Anne Morrow
KING	LAURIE R.
Duprau	Jeanne
Erdrich	Louise
Haynes	Melinda
Yang	Belle
Shields	Carol
Nabokov	Vladimir Vladimirovich
Powers	Tim
Lorrah	Jean
Wilde	Oscar
Beer	John
Coelho	Paulo
Erskine	Barbara
Arens	Annegrit
Alpers	Hans Joachim
Hesse	Hermann
Zglinicki	Claudia von
Miller	Linda Lael
Feather	Jane
L'AMOUR	LOUIS
Forstchen	William
Robinson	Spider
McKiernan	Dennis L.
Rush	Mallory
Fenn	Lionel
Halston	Carole
Rimmer	Christine
James	BJ
Capote	Truman
Scott	Darrell
Goethe	Johann Wolfgang Von
Elsaesser	Thomas
Plass	Adrian
Mccourt	Frank
Quirke	Stephen
Herbert	James
Sutcliffe	William
Brunhoff	Jean de
Fix	Philippe
Keller	Claudia
Wilson	F. Paul
Lazarus	Arnold A.
Estes	Clarissa Pinkola
Jensen	Virginia Allen
PALAHNIUK	CHUCK
Allen	John Paul
Trudeau	G. B.
Larson	Gary
Keillor	Garrison
Breathed	Berke
Kipfer	Barbara Ann
FRIED	STEPHEN
Stephanopoulos	George
Brown	Rita Mae
Funke	Cornelia
Lee	Stan
Paglia	Camille
Kahn	James
McBride	James
Sachar	Louis
Lustbader	Eric Van
Asprin	Robert
FRANK	ANNE
Feverstein	Georg
Eve	Nomi
Catton	Bruce
Gibson	William
Eaton	Clement
Kinsella	Sophie
Collins	Judy
Sacks	Oliver W.
Broadrick	Annette
Cohn	Rachel
Keene	Carolyn
M.D.	Rachel Naomi Remen
Krentz	Jayne Ann
Smith	Joan
Gibbons	Kaye
Chandler	Bryn
Brewster	Tod
Osborne	Eliza
Norman	Howard
Griesemer	John
Swick	Marly A.
L'Heureux	John
Ivins	Molly
Carter	Forrest
Eco	Umberto
Bear	Greg
Reichs	Kathy
Deaver	Jeffery
Smith	Martin Cruz
Andrews	V.C.
Hill	Stephen
Heine	Ernst W.
Fletcher	Donna
Larsen	Jeanne
Wood	Bari
Cozzens	James Gould
Jonsson	Reidar
Clark	June Vendall
Reilly	Robert
Nunn	Kem
King	Larry
Gaines	Ernest J.
Lamott	Anne
Lott	Bret
Hurston	Zora Neale
Fisher	Jude
Rushdie	Salman
Taylor	G. P.
Bryson	Bill
MCCAFFREY	ANNE
Pullman	Philip
Astley	Judy
Allen	Roger E.
Tempest	Margaret
Barclay	James
Gibran	Kahlil
Purves	Libby
KIRKPATRICK	JANE
GERRITSEN	TESS
Burns	Olive Ann
Ende	Michael
Boom	Corrie Ten
Thoene	Bodie
Schalesky	Marlo
SALZMAN	MARK
Smith	Alexander McCall
Paterniti	Michael
Miller	Dorothy Reynolds
Martin	Steve
Yoshimoto	Banana
Jonas	Ann Rae
Digest	Readers
Campbell	Joseph
Gibson	Dyanne
Asimov	Isaac
Coville	Bruce
BROOKS	TERRY
Danticat	Edwidge
Lansdale	Joe R.
PEREZ-REVERTE	ARTURO
O'Connor	Sheila
LARSON	ERIK
Bellow	Saul
Millman	Dan
Vizzini	Ned
Anderson	Laurie Halse
Wooding	Chris
Morris	Mary McGarry
O'Leary	Brian
Peat	F. David
Hubbard	L. Ron
Coonts	Stephen
WHITMAN	JOHN
Kummer	Peter
Regener	Sven
Leigh	Wendy
Sterling	Dorothy
Iyengar	B. K. S.
Atkinson	Kate
McIntosh	Susan M.
Gross	Paul
Muldrow	Diane
Bloch	Robert
Molay	Mollie
Colling	Grace
Blume	Judy
Rabb	Jonathan
Robinson	Patrick
BAKKER	ROBERT T.
Saberhagen	Fred
Moran	Richard
Dimercurio	Michael
Collins	Wilkie
Cloutier	Raymond
Wallace	Randall
Huffey	Rhoda
TRILLIN	CALVIN
Simon	Rachel
Earls	Nick
Emshwiller	Carol
Robbins	Tom
Konecky	Edith
HARR	JONATHAN
Hannah	Kristin
Rand	Ayn
ATWOOD	MARGARET
DUMAS	ALEXANDRE
Garlock	Dorothy
Otto	Whitney
Cunningham	Michael
Ackerman	Diane
Isaacs	Susan
Preston	Douglas
Robinson	Kim Stanley
Safire	William
Glass	Leslie
Fitzgerald	F.Scott
Spellman	Cathy Cash
Slick	Grace
Bledsoe	Jerry
Sigaloff	Jane
Keyes	Marian
Fried	Stephen
Rossi	Melissa
Collins	Jackie
Barrymore	Drew
Alexander	Carrie
Handeland	Lori
Salonen	Debra
Laake	Deborah
Way	Margaret
Carroll	Marisa
Duran	Eduardo
Eggers	Dave
Soto	Hernando De
Miller	Julie
Fforde	Jasper
Holden	Wendy
Faulks	Sebastian
MARGOLIS	SUE
Mossanen	Dora Levy
Holman	Sheri
Susann	Jacqueline
Laurens	Stephanie
Mendelsohn	Jane
Swindells	Madge
Adams	Richard George
Colapinto	John
Kurthy	Ildiko
McPhee	John
Vonnegut	Kurt
Vienne	Veronique
MARAI	SANDOR
McMenamin	Mark A. S.
Robinson	Nancy K
Lund	Jillian
Rinaldi	Ann
O'Dell	Scott
ROCKWELL	THOMAS
Plummer	Louise
Duncan	Dave
Awlinson	Richard
Ciencin	Scott
Kennealy-Morrison	Patricia
Czerneda	Julie E.
Heller	Eva
McDaniel	Jan
Dellin	Genell
Neels	Betty
Dolan	Barbara
Carlysle	Viveca
Jackson	Judy
Orde	Lewis
Sparks	Beatrice
Mayle	Peter
Dick	Philip Kindred
Kennedy	Douglas
Dick	Philip K.
Huxley	Aldous
Poe	Edgar Allan
Danielewski	Mark Z.
Vicomte	Laurent
Bonnefoy	Jean
Dick	Philip K. (Philip Kindred)
Camus	Albert
Berenstain	Stan
Wood	A. J.
Griffin	Sunny
Inc	Disney Enterprises
Silverman	Maida
Giraudoux	Jean
Ross	Nicholas
Banks	Lynne Reid
Wheat	Carolyn
SIMMONS	DAN
Stanley	Ros
Stine	R. L.
Barlow	Steve
Applegate	Katherine
Christopher	Matthew F
Friend	Marilyn Penovich
Herbert	Brian
Stephens	C. A.
Gravalos	Mary Evans O'Keefe
Rothenberg	Randall
Mills	Enos A.
FITZGERALD	JOHN
Vassalli	Sebastiano
McGrath	Patrick
Kotzwinkle	William
Bugliosi	Vincent
Richard	Mark
Elton	Ben
International	Ltd Editorial Staff Publication
RUSSELL	MARY DORIA
Harris	MacDonald
Goldstone	Lawrence
Land	Leslie
Ducornet	Rikki
HUGO	VICTOR
Egan	Jennifer
Smith	Dodie
Lowe	Doug
Eisenberg	Arlene
GREEN	JANE
Ezzo	Gary
Rainey	Dennis
Gardner	David
Vinge	Joan D.
MacAvoy	R. A.
Stevens	Brooke
Ross	Ann B.
Trigiani	Adriana
CAMPBELL	BEBE MOORE
Corcoran	Barbara
Hassinger	Amy
Jong	Erica
Palmer	Diana
Tolkien	J.R.R.
Godfrey	Rebecca
Battle	Lois
Ginsberg	Allen
TYLER	ANNE
Greeley	Andrew M.
Davis	Rick
Church	Catholic
McBride	Alfred
Ford	Russell L.
Davies	Robertson
Watterson	Bill
Kasun	Jacqueline
Meier	Leslie
Netzer	Corinne T.
Benni	Stefano
Baricco	Alessandro
Adams	Alice
Buechner	Frederick
Frisch	Max
Pynchon	Thomas
Charles	Veronika Martenova
Hubbard	Ron L.
Pilkington	Doris
Gallagher	Stephen
Stevenson	Robert Louis
Currie	Edwina
Mackenzie	Donald A.
Verne	Jules
Lee	Laurie
Siciliano	Sam
Haldeman	Joe
Uris	Leon
Boukreev	Anatoli
Lewis	Steve
Deighton	Len
Anderson	Dale L.
Golding	William Gerald
Mann	William J.
Hamilton	Laurell K.
Reese	James
Sheindlin	Judge Judy
Suri	Manil
SULLIVAN	VICTORIA
Amis	Kingsley
Cooper	Dale
Walker	Scott
Clement	Catherine
Toibin	Colm
Weber	Joe
Carr	Caleb
Baxter	Stephen
Burroughs	Augusten
Dunn	Mark
Carpenter	William
Eddings	David
PLAIN	BELVA
Case	John
Cross	Donna Woolfolk
KRAKAUER	JON
Krakauer	Jon
Haddon	Mark
Ryan	Michael
Tanenbaum	Robert K.
Wallace	Judi Lawson
D'Adamo	Peter J.
Wiggin	Helene
Levin	Ira
Lindsay	Norman
Lamb	Christina
Michael	Crichton
Phelan	Nancy Creagh
BOHJALIAN	CHRIS
Peck	M. Scott
Kaye	M. M.
Creech	Sharon
Jacq	Christian
Devlin	Dean
Marney	Dean
Ettler	Justine
Brown	Margaret Wise
Arensen	Shel
McKay	Amanda
Djerassi	Carl
O'Faolain	Nuala
Strobel	Lee
Rains	Sally
authors	various
Raffel	Burton
McMillan	Terry
Lassiter	Don
Stewart	Jimmy
WILBER	KEN
Cosby	Bill
Gordon	Ruth
O'Connor	Flannery
Mitchell	Adrian
Davis	Donald A.
Silko	Leslie Marmon
Root-Bernstein	Robert S.
Jenkins	Beverly
Frank	Dorothea Benton
Christie	Agatha
Brookner	Anita
Hecht	Daniel
Daher	Anita
Lawhead	Stephen R.
White	Robin A.
White	Stephen
Archer	Jeffrey
Maupassant	Guy De
Kellerman	Jonathan
Wilson	Robert Charles
Deleuze	Gilles
Weber	Peter
Gifford	Thomas
Hijuelos	Oscar
Shangdi	Taiping
Schmidt	Harald
Danesh	Arman
Callery	Emma
Beman	Donald
Inc.	Guinness Media
Brate	Adam
Levis	Bob
Gran	Maurice
Smith	J
CARTER-SCOTT	CHERIE
Hansen	Mark Victor
NILSSON	LENNART
Bovee	Courtland L.
Freemantle	David
Waddock	Sandra
Narayanan	V.K.
Mische	Michael
Douglas	Ann
Kelly	Fergus
Mailer	Norman
Ryman	Geoff
Greene	Graham
Leroux	Gaston
Durckheim	Karlfried
Coontz	Stephanie
Redmond	Laure
Tartt	Donna
Barry	Lynda
Cauti	Fernando Iwasaki
Reig	Rafael
Jouvet	Laurent
Block	Francesca Lia
Clark	Carol Higgins
Pyper	Andrew
Atkins	Robert
Orr	Wendy
Ephron	Amy
Vreeland	Susan
Cumming	Alan
Russo	Christopher
ROBILANT	ANDREA DI
Epstein	Alan
Andahazi	Federico
Vickers	Salley
MARTIN	RUSSELL
Masters	Roger D.
Meisler	Andy
King	Ross
BROWN	MARC
Books	Writer's Digest
Weinmann	Elaine
Sheffield	Charles
Bujold	Lois McMaster
Pears	Iain
Barnes	John
AUEL	JEAN M.
Cleveland	Joan
Simmons	Wilson, III
Kiraly	Sherwood
Decaro	Frank
Ludlum	Robert
Sacks	Oliver
Woolf	Virginia
Wada	Junko
Wolkstein	Diane
Garrard	Alice
Fitch	Janet
Rodegast	Pat
Dalby	Richard
Hoffman	William
Wallace	David Foster
Pilkey	Dav
James	Clive
Logan	Chuck
Suskind	Patrick
Rollins	James
Walters	Minette
FLAGG	FANNIE
FAULKNER	WILLIAM
Lederer	Joseph
Wolf	Joan
Stabenow	Dana
Lawrence	R.D.
Updike	John
DeBartolo	Tiffanie
Kapuscinski	Ryszard
Anderson	Kent
Lobsang	Rampa
BERNHARDT	WILLIAM
Bova	Ben
Nye	Naomi Shihab
Quinn	Daniel
Tacey	David J
Pierce	Todd James
Goonan	Kathleen Ann
Winterson	Jeanette
Tripp	Valerie
Lees	Christof
Saul	John
McDermid	Val
Garwood	Julie
L'Engle	Madeleine
PACKER	ANN
Frost	Gregory
Millett	Larry
Moberg	Vilhelm
Diven	Gail
Alter	Stephen
Windling	Terri
Moorcock	Michael
Chandra	Vikram
Divakaruni	Chitra Banerjee
Slavicsek	Bill
Anderson	Richard L.
Sartre	Jean Paul
Pritchard	Sara
Guin	Ursula K. Le
Stephenson	Neal
Chaudhuri	Amit
MILES	ROSALIND
West	Stanley Gordon
Caudwell	Sarah
Welsh	Irvine
DeMille	Nelson
Gotlieb	Phyllis
Paxson	Dianna L.
Godwin	Gail
McGowan	Wynema
WAGAMESE	RICHARD
Haas	Robert
Yeo	Wilma
Castle	Jayne
Longden	Deric
Robb	J. D.
Munger	Katy
Dingwall-Main	Alex
Buzan	Tony
Sampedro	Jose Luis
Durrell	Lawrence
Butler	Octavia E.
Naylor	Gloria
Pipher	Mary
O'Donohue	John
Spence	Jonathan D.
Fletcher	Janet Kessel
Doyle	Roddy
Gelman	Rita Golden
Huang	Alfred
Rinpoche	Tulku Thondup
Orejudo	Antonio
BRADLEY	MARION ZIMMER
Black	Holly
Golden	Christopher
Marias	Javier
Green	Jane
BROWN	SANDRA
Dickinson	Charles
Robinson	Fay
Magner	Lee
Ferrarella	Marie
Bauer	Pamela
Mckade	Kim
Rowling	J. K.
Garbera	Katherine
Kauffman	Donna
Bowen	Judith
Pozzessere	Heather Graham
Burke	Ron
Warren	Nancy
Flanders	Rebecca
Denton	Jamie
Matlock	Curtiss Ann
Simmons	Suzanne
Farr	Diane
Carr	Robyn
Dalton	Margot
Flores	Janis
Welsh	Kate
Parry	Richard
Henrick	Richard P.
Riker	H. Jay
Heller	Jean
Wilson	George C.
HEATH	L.
Thomas	Craig
Homewood	Harry
Tamaro	Susanna
Salinger	J. D.
Gordon	Noah
George	Jean Craighead
Stepansky	June
Lippman	Laura
Roth	Philip
Styron	William
Zelazny	Roger
Hillier	Malcolm
Pratchett	T.
Sansot	Pierre
Levi	Primo
Maurquez	Gabriel Garcaua
Garcia	Cristina
Ragen	Naomi
Wallach	Janet
Hart	Carolyn G.
Collier	Michael
Pronin	Barbara
Paulsen	Heather Arnel
Covey	Stephen R.
O'Connor	Joseph
Burton	Anne
Fyfield	Frances
Simpson	Dorothy
Fowler	Connie May
Schwab	Charles R.
Parker	Barbara
Paasilinna	Arto
Dawkins	Richard
Herbert	Frank
Maas	Peter
Association	American Psychiatric
Shaara	Michael
Pye	Donna-Marie
Loewen	James W.
Ludlow	Anna
Jordan	Robert
Freud	Sigmund
HERRIGEL	EUGEN
Augustine	St.
Milgram	Stanley
Tzu	Sun
Musashi	Miyamoto
Axford	Ray
Kushner	Kenneth
Hester	Elliott
Hathorn	Libby
Temple	Paul
Moloney	James
Parkinson	Dan
Gear	Kathleen O'Neal
Schallingher	Sophie
Fairley	Josephine
Burns	R. T.
Anderson	Poul
Aldrin	Buzz
Greeley	Andrew M
Saulnier	Beth
Conover	Ted
Kirkpatrick	Jane
Tatem	Mary
ALBOM	MITCH
Connor	Tom
Carlin	George
Delany	Sarah Louise
Beattie	Melody
Coben	Harlan
Marcinko	Richard
Bernhardt	William
Klavan	Andrew
Siler	Brooke
McKay	Matthew
Stains	Laurence Roy
Hopkins	David
Csikszentmihalyi	Mihaly
Truss	Lynne
Wilson	Paul
Appel	Joachim
Goldberg	Whoopi
Carey	Drew
Winokur	Jon
Buckland	Warren
Diestler	Sherry
Sloane	Paul
SAFIRE	WILLIAM
Jr.	William Strunk
Maggio	Rosalie
Browne	M. Neil
Buss	David M.
Burns	David D.
Lowndes	Leil
Allen	Roberta
Codell	Esme Raji
McAlindon	Harold R.
O'Connor	Richard
Rossi	M. L.
Walbaum	John T.
Wise	Nina
Linse	Caroline
Andersen	H.C.
Ford	Claire Maria
Ph.D.	Warren Farrell
KEYES	DANIEL
Holt	Tom
Tuchman	Barbara W.
Moorhouse	Frank
Hughes	Robert
Yergin	Daniel
Mosley	Walter
Ribon	Pamela
Philbrick	Rodman
Batz	Jeannette
Goodnight	Linda
Anderson	Madelyn K.
Devon	Gary
Beasant	John
Meltzer	Brad
Carre	John le
Isherwood	Christopher
Frankl	Viktor E.
Gochnauer	Cheryl
Lehane	Dennis
Barnes	Z.
Boyer	Robert
Lindsey	Johanna
Pennac	Daniel
Adrienne	Carol
Sartre	Jean-Paul
Sanders	Lawrence
Wagner	Edward Karl
Hyde	Catherine Ryan
Sodrau1993	Muniz
Schneider	Roberto
Leau	Pedro de Cieza de
Booss	Claire
Cana	Proinsias Mac
Joyce	P W
Matthews	Caitlin
Caduto	Michael J
Museum	British
Davis	Courtney
Cirker	Blanche
Garner	James Finn
Baker	Mark
KELLERMAN	JONATHAN
Iles	Greg
Adams	Scott
Franklin	Jon
Timms	Roxana Ferllini
Pearson	Ridley
Simpson	Thomas William
Baden	Michael
Bachman	Richard
Child	Lee
Mitchell	W.R.
Brown	Dale
O'Connell	Carol
GRAFTON	SUE
Flanagan	Richard
Smith	Bradley
Hamilton	Wallace
Wolff	Larry
Mohr	Richard D.
Richmond	Len
Bronski	Michael
Boswell	John
Hendin	Herbert
Marcus	Eric
Gever	Martha
Goldstein	Laurence
Higgins	Patrick
Kirk	Marshall
Schmidgall	Gary
Shewey	Don
HOPCKE	ROBERT H.
Spencer	Colin
Jacques	Trevor
Lippard	Lucy R.
Gottlieb	David
Hippler	Mike
Rofes	Eric E.
Sams	Jamie
Mccollister	John
Browne	Sylvia
MacLaine	Shirley
Gawain	Shakti
Redfield	James
Roth	Gabrielle
Dreamer	Oriah Mountain
Buerge	David
Bennett	Hal Zina
Cornelius	Geoffrey
Chunovic	Louis
Weiner	Ellis
Morrow	Rob
Scieszka	Jon
Adams	Ansel E.
Stone	Jana
Prabhupada	A. C. Bhaktivedanta Swami
Wilson	Joyce
Moyers	Bill D.
Murphy	Francis
Barks	Coleman
Hillman	James
Andrews	Lynn
Skoog	Douglas A.
McMurry	John
Atkins	P. W.
Milne	A. A.
Leigh	Susannah
Allen	Tim
Journal	Staff of the Wall St
Lansky	Bruce
Curtis	Patricia
Daly	Carol Himsel
Lewis	Cynthia Copeland
Salzmann	Cyndy
Raskin	Ellen
Herriot	James
Fox	Marye Anne
Shriver	D.F.
Carey	Jacqueline
Shatoff	Debra K., Dr.
Cramer	Christopher J.
Bell	Quentin
Keene	Raymond D
Grivainis	Kon
Coles	R. N.
Farmer	Nancy
Moore	Susanna
Dubner	Stephen J.
Williamson	Marianne
Roiphe	Katie
Kazantzakis	Nikos
ELLIS	BRET EASTON
Johnson	Charles
Mathabane	Mark
Pipher	Mary Bray
McInerney	Jay
Halperin	James L.
Egan	Greg
Colombo	Furio
Ancona	George
Meier	Susan
Clarke	Anna
Hamilton	Diana
Monroe	Lucy
Armstrong	Lindsay
Darcy	Emma
Putney	Mary Jo
Sorensen	Chris
Pluhar	Erika
Jimenez	Iker
Mendoza	Eduardo
BROWN	DAN
Savaiano	Eugene, Ph.D.
Lerangis	Peter
Cauwelaert	Didier Van
Neville	Katherine
Beigbeder	Frederic
Willis	Roy
Perez-Reverte	Arturo
Gandara	Alejandro
Reverte	Arturo Perez
Miller	Isabel
Spencer	LaVyrle
Jacques	Brian
Powers	Alice Leccese
Hailey	Arthur
McDevitt	Jack
Johnston	Terry C.
Gerritsen	Tess
Forsyth	Frederick
Frost	Mark
Jhabvala	Ruth Prawer
Maynard	Chris
Anton	Ted
Nelson	Peter
Enquist	Per Olov
Bull	Emma
Weber	David
Sjowall	Maj
Marks	Leo
Pollack	Kenneth M.
Nafisi	Azar
Horwitz	Tony
Enger	Leif
Eadie	Betty J.
Gilmour	H. B.
Moran	Elizabeth
Beach	Lynn
Faber	Adele
Burstein	Patricia
Stick	David
Foster	Alan Dean
Glut	Donald F
Jenkins	Peter
Group	Earthworks
Ross	Cindy
McHugh	Gretchen
Feaster	Sharon A.
Stine	R.L.
Edwards	Anne E.
Kaye	Marilyn
Korman	Gordon
Martin	Ann M.
Page	Khristine
Coffman	Elaine
FEATHER	JANE
Foley	Gaelen
Delacroix	Claire
Gibson	Rachel
Bevarly	Elizabeth
Rogers	Rosemary
Child	Maureen
Edwards	Cassie
Greenwood	Leigh
Canham	Marsha
Alexander	Victoria
Mason	Connie
Ryan	Nan
Brandewyne	Rebecca
Phillips	Susan Elizabeth
Joyce	Brenda
Britton	Pamela
Hill	Sandra
Ivory	Judith
PROCTOR	CANDICE
Hunter	Madeline
Lee	Linda Francis
Baker	Madeline
Litton	Josie
Stacy	Judith
Civil-Brown	Sue
Ross	JoAnn
Graham	Heather
Rice	Patricia
George	Melanie
Smith	Barbara Dawson
Lane	Connie
Kleypas	Lisa
Carter	Karen Rauch
Lagasse	Emeril
Chu	Chin-Ning
Stone	W.
STEWART	THOMAS A.
Neruda	Pablo
Simmons	Marie
Moffatt	Bettyclare
Frissell	Bob
Smith	Julie
Peters	Ellis
Bayley	John
Small	Stephen J.
Palmieri	Marco
Szpilman	Wladyslaw
Carter	Carmen
Paton	Alan
Walker	Anthony, Md.
DiTerlizzi	Tony
Willard	Fred
Narvaez	Concha Lopez
Wilbur	Richard
Suter	Martin
Anderson	Kevin J.
Spencer	Wen
Schuchman	John S.
LLYWELYN	MORGAN
Moon	Elizabeth
Walker	Lou Ann
Friedman	C.S.
GIBSON	WILLIAM
Moore	Matthew S.
Tucker	Bonnie Poitras
Hines	Lillian M.
Gresh	Lois H.
Llywelyn	Morgan
Friedrich	Ernst
Grant	Bruce K.
Wilcox	Sherman
Evans-Wentz	W. Y.
Horne	Fiona
Huff	Tanya
Monroe	Douglas
Coddington	Mary
Mickaharic	Draja
Edgerton	Teresa
Flaubert	Gustave
Gourevitch	Philip
Huston	Nancy
James	P.D.
Goldberg	Myla
Karr	Mary
CHANDLER	RAYMOND
Alten	Steve
Publishing	Smithmark
Hopkinson	Nalo
Voigt	Cynthia
Gowdy	Barbara
Munro	Alice
Gildiner	Catherine
Collins	William Wilkie
Dieguez	Sharlee
Gibbons	Stella
Williams	Maurice A.
Uhlman	Fred
Rochon	Esther
Pearl	Matthew
Gruen	Arno
benShea	Noah
Snow	Elliot
Michael	Judith
Sprinkle	Patricia
Parkhurst	Carolyn
Bourdain	Anthony
Hamilton	Lyn
Chase	David
Perls	Frederick S.
Perrin	Elula
Salvatore	R.A.
Salmonson	Jessica Amanda
Salmonson	Jessica
Carey	Diane
Thorsten	Geraldine
Donsbach	Jurt W.
Silverberg	Robert
Rusch	Kristine Kathryn
Graf	L. A.
Navratilova	Martina
Lear	Peter
Randall	Marta
Reaves	Michael
Clayton	Jo
Piper	H. Beam
Pollotta	Nick
Peak	Michael
Jr.	James Tiptree
Phillips	Denning
Junjulas	Craig
Woudhuysen	Jan
Williams	Tad
Smoke	Stephen
Banks	Dale
Feist	Raymond E.
Hansen	Ron
Rickman	Phil
Bateman	Tracey V.
Morris	Gilbert
Kelly	Leisha
Hunter	Denise
Donnelly	Jennifer
Kearney	Susan
Daniels	B.J.
Kelly	Virginia
Whiddon	Karen
Gaines	Alice
Mills	Jenna
Shayne	Maggie
Buck	Gordon
FOSTER	ALAN DEAN
Ryan	Kevin
Doyle	Elizabeth
Herring	Linda
Winchester	Simon
Thor	Brad
Toubbeh	Jamil I.
Rose	M. J.
Hofstadter	Douglas R.
Wagner	Cosima
Merlis	Mark
Laye	Camara
Powers	William K.
Eddy	Mary Baker
Brown	Karen McCarthy
Okada	John
Murayama	Milton
Greer	Andrew Sean
Trotter	Robert T., Ii
SUSKIND	RON
Smith	Anna Deavere
Uno	Roberta
Valdez	Luis
ULRICH	LAUREL THATCHER
Ryan	K.
Bohjalian	Chris
Saavedra	Miguel de Cervantes
Carver	Raymond
ROSTAND	EDMOND
CAPOTE	TRUMAN
Epel	Naomi
Dostoyevsky	Fyodor
Captain	George Galdorisi
Davis	Patrick A.
Queiros	Eca de
Kuralt	Charles
Amory	Cleveland
Rogers	Susan Fox
Mohin	Andrea
Fauglid	Anthony M.
Murray	Victoria Christopher
Tozer	Aiden W.
Buck	Pearl S.
Lowry	Lois
Hurnard	Hannah
Jakes	T. D.
Kaminsky	Howard
Lissner	Caren
Vincent	Paul
Kinkel	Tanja
Hegewisch	Helga
Leon	Donna
Johansson	Kjell
Mankell	Henning
Mercer	Judy
Carlson	Richard
Morley	Patrick
Littke	Lael
Cover	Arthur Byron
Brightfield	Richard
Packard	Edward
GEORGE	ELIZABETH
Nye	Jody Lynn
Niven	Larry
Dechancie	John
Debrandt	Don H.
Kassirer	Norma
Greenwald	Sheila
Johnson	Norma Tadlock
Kenyon	M.L.
Shwartz	Susan
Trivelpiece	Laurel
McIntyre	Vonda N.
BISCHOFF	DAVID
Perry	Steve
Charrette	Robert N.
Smith	Nyx
Sargent	Carl
Findley	Nigel D.
Kenson	Stephen
Smedman	Lisa
Dowd	Tom
Odom	Mel
Weisman	Jordan K.
Spector	Caroline
Griffin	W. E. B.
Dozois	Gardner
DOHERTY	ROBERT
Flynn	Vince
Rey	Margret
KAYSEN	SUSANNA
Reisert	Rebecca
Bauby	Jean Dominiqu
Lindsey	David L.
Kirshenbaum	Binnie
Russo	David Anson
Shatner	William
Emerson	Earl W.
Brown	Mary
Rinehart	Mary
Bernall	Misty
Holmes	Shannon
Stalmann	Franziska
Dexter	Colin
Biermann	Pieke
Paglieri	Claudio
Heuck	Sigrid
Rankin	Ian
Alexander	Bruce
Ani	Friedrich
Vanderbeke	Birgit
Books	Golden
Williams	H
Andersen	C. B.
Meyers	Susan
Clover	Peter
Garner	Alan
Miller	Arthur
Fisher	Robert
Brett	Simon
Katzenbach	John
Kurland	Lynn
Kidd	Chip
Pollack	Neal
Adams	Richard
Oe	Kenzaburo
Lucarelli	Carlo
French	Nicci
Moers	Walter
Sawyer	Robert J.
Heinlein	Robert
Willis	Connie
Martin	William
Romkey	Michael
Sloan	Susan R.
Hunter	Evan
Austin	Lynn N.
Sobel	Dava
Jance	J.A.
Meehan	Aidan
Kirkpatrick	Sidney D.
Huth	Angela
Goytisolo	Juan
Rivas	Manuel
Weaver	Sherrie
Wodehouse	P.G.
CRANE	STEPHEN
Sayers	Dorothy Leigh
Walser	Martin
Colfer	Eoin
Seiskind	Patrick
McLiam-Wilson	Robert
Illies	Florian
Schulman	Michael
Moore	Shelia
Thom	James Alexander
Graham	Katharine
Cooley	Martha
Pelzer	Dave
Dobson	James
Nown	Graham
Chew	Ruth
Gough	Julian
Murkoff	Heidi
Cross	Amanda
Jacobson	Alan
Lynds	Gayle
Parsons	Julie
Moore	Brian
Karoly	Jil
Hart	Maarten 't
Leary	Timothy
Newkirk	Ingrid
Curtis	Deborah
Kadet	Gary S.
Kemeny	John G
Kureishi	Hanif
Prater	Gene
Rooney	Andy
Young	Toby
Levine	Joshua
Philby	Rufina
Pollock	Ellen
Cowman	L. B.
Bagdon	Paul
Kelton	Elmer
LaHaye	Tim
Madaras	Larry
Holt	Victoria
Miller	John R.
Michener	James A.
Skye	Christina
Ambrose	Stephen E.
Stevenson	James
Caras	Roger
Tarr	Judith
Baxt	George
Hepinstall	Kathy
Webber	Meredith
BROWN	RITA MAE
Coughlin	William J.
Castillo	Ana
Shaw	George Bernard
Haasse	Hella S.
Zitelmann	Arnulf
Cushman	Karen
Dahl	Sophie
Bronte	Charlotte
May	Julian
MacAvoy	R.A.
Fisher	R. L.
L'ENGLE	MADELEINE
Drakulic	Slavenka
Fitzgerald	Penelope
Disch	Thomas M.
Eliot	T. S.
Penman	Sharon Kay
Burroughs	William S.
White	T.H.
Hanff	Helene
Gorman	Edward
Newman	Kim
Heller	Barbara L.
Evans	Roland
Brehony	Kathleen A.
Drewe	Robert
Maurensig	Paolo
Fuentes	Carlos
Kelder	Peter
Lama	Dalai
Kaminer	Wladimir
Pascal	Francine
Doyle	Arthur Conan
Jenkins	Jerry B.
Morreale	Marie
Whitney	Brooks
Park	Barbara
Hall	Katy
BLUME	JUDY
Higgs	Liz Curtis
Lindgren	Astrid Ericsson
Holder	Nancy
Gallagher	Diana G.
Reisfeld	Randi
West	Cathy
Barnes-Svarney	Patricia
Porter	Connie
Maclachlan	Patricia
Erickson	John R.
Konigsburg	E. L.
Harris	Robert
Ishiguro	Kazuo
Carrau1980	John Le
Auel	Jean M.
Hajdu	David
Lunn	Janet Louise Swoboda
Roca	Josep
ASIMOV	ISAAC
Packer	ZZ
Krahn	Betina M.
Puzo	Mario
Friedman	Kinky
Chang	Jolan
Easton	Dossie
Macaulay	David
Lammle	Todd
Collins	Terah Kathryn
WELLS	H.G.
Villoro	Juan
Fuentes	Julio
Maalouf	Amin
Thompson	Victoria
Williams	Joy
Train	John
Valles	Carlos G
Gannon	J. Patrick
Goldberg	Philip
Shepard	Odell
Pickard	Nancy
Black	Ethan
White	Bailey
Carvalho	Maurio de
Press	Editors of Phaidon
Robbins	John
RAND	AYN
Bryant	Bonnie
Wearing	Alison
Thurber	James
Baigent	Michael
MORRISON	TONI
Remen	Rachel Naomi
Lewin	Jackie
ORLEAN	SUSAN
Evers	Crabbe
Wright	Nancy
Heron	Lisa Langford
Zafon	Carlos Ruiz
Cashwell	Peter
MCCULLERS	CARSON
Woodward	Bob
Zaid	Gabriel
Hosseini	Khaled
Company	Houghton Mifflin
Thomas	James
Gogol	Nikolai Vasilevich
Lewis	Charles
Skloot	Floyd
Coupland	Douglas
Stoppard	Tom
West	Cornel
Wiesel	Elie
Englander	Nathan
Carter	Susan
Coll	Pep
Olaizola	Jose Luis
Hinton	Susan E.
Cooper	Louise
Marie	de France
Marsan	Hugo
Beigbeder	Frauauic
Kemp	Percy
Ruiz	Miguel
Amado	Jorge
Ravalec	Vincent
Tabucchi	Antonio
Dodd	Christina
Henley	Virginia
Dunning	John
Berriault	Gina
Nelson	Antonya
Vetere	Richard
Thornhill	Ann
Quisling	Erik
Booher	Dianna
Naylor	Grant
Masterton	Graham
DUNNE	DOMINICK
Sijie	Dai
Bagshawe	Louise
Bolles	Richard Nelson
Newman	Jenny
Sweeney	Charles W.
Allen	Conrad
Arana	Marie
Sellwood	A. V.
Lucas	James
Zimmer	William
Miller	Robert A.
Wilson	George
Burgett	Donald R.
Angelo	Bonnie
Graham	Lawrence Otis
Strait	Raymond
SIDES	HAMPTON
Putney	William W.
SAMUEL	WOLFGANG
Naveen	Ron
Flannery	Sean
SARABANDE	WILLIAM
Glenn	Dorothy
Eckert	Allan W.
Kelman	James
Kelley	Kitty
KAUFMAN	PAMELA
Levey	Michael
Richardson	Joanna
Gurko	Miriam
Ferris	Monica
Skemp	Sheila L.
Tuchman	Barbara Wertheim
Hickman	Katie
Perry	Maria
Dolan	Brian
Fields	Bertram
Hill	Frances
Newdick	Jane
Morton	Andrew
Vanzant	Iyanla
Michaud	Ellen
Gordeeva	Ekaterina
Association	The Staff of Research Education
Crespi	Camilla T.
McWilliams	Peter
CLARK	MARY HIGGINS
Broder	Michael
Luhrs	Janet
Angelis	Barbara De
CONRAD	JOSEPH
Greenberg	Blu
Mitchell	Mary Ann
Wood	Patrick
Tervo	Jari
Prevert	Jacques
Bantock	Nick
Maruca	Mary
Calvino	Italo
Block	Thomas
Elgin	Suzette Haden
Ryan	M. J.
Patricia	Cornwell
Coetzee	J. M.
Garland	Alex
Fielding	Joy
Philbrick	Nathaniel
Watson	Jude
Jr.	E. Donnall Thomas
Mackay	Shena
O'Neill	J. M
Spinka	Penina Keen
Renault	Mary
Bobin	Christian
Bauby	Jean-Dominique
GAINES	ERNEST J.
Barron	T. A.
Dinesen	Isak
Ahlberg	Janet
Finder	Joseph
McNeill	Dan
Kam-Chuen	Master Lam
Block	Lawrence
Eliot	George
Spindler	Erica
Gloeckner	Phoebe
Dobyns	Stephen
Bishop	Anne
Tademy	Lalita
Forster	R. A.
Liu	Aimee
Maxwell	Cathy
Karp	Harvey
Bretton	Barbara
Ashley	Mike Ed
GISCHLER	VICTOR
Estleman	Loren
Rehder	Ben
Jensen	Carl
Stephens	Mitchell
Cronkite	Walter
Hamill	Pete
Rather	Dan
Drudge	Matt
Brown	Crosland
MARGOLIN	PHILLIP M.
Muller	Marcia
Michaels	Kasey
Robinson	Bruce
Spector	Craig
SACHAR	LOUIS
Fulghum	Robert
Okeefe	Susan H
Orton	Joe
Hagen	Uta
Carr	Josephine
MacLean	Allistair
Benchley	Peter
Uecker	Bob
Blish	James
Jones	Diana Wynne
Erdoes	Richard
Butcher	Jim
Fleming	Ian
Mccaffrey	Anne
Swann	E. L.
Lee	Gentry
Vornholt	John
Seuss	Dr.
Daley	Robert
Jones	Catherine
Proulx	E Annie
Press	Running
Diamond	Jared
Frazier	Ian
McCoy	Edain
Dufresne	John
Preston	Fayrene
Miller	Rand
Cunningham	Scott
Farren	Caela
Blundell	William E.
Delbanco	Andrew
Duras	Marguerite
Lagerkvist	Par
Kaplan	Alice
Beard	Jo Ann
Brande	Dorothea
Dumas	Alexandre
Trottier	Maxine
Bricklin	Mark
Wilson	Derek A
Gadd	Iris
ROSS	DANA FULLER
Boie	Kirsten
Butler	Gillian
Lloyd	Marjorie L.
Fontana	David
Norton	Mary
Sepulveda	Luis
Emerick	Yahiya
GANNON	MICHAEL
Louise	Brindley
Dalton	Robin
Torres	Raaul
Salten	Felix
Pineiro	R. J.
Forbes	Colin
Shaw	Patricia
Ortese	Anna Maria
Doherty	Paul
Biehl	Frauke
Nothomb	Amelie
MacLean	Alistair
Lurie	Alison
Meade	Glenn
Folsom	Allan
Zinn	Dorit
Durst-Benning	Petra
Maaser	Eva
Bayly	Jaime
Dauaz	Lindy Arriaga
Post	Laurens van der
Pierre	Clara
Lawhead	Stephen
Berger	Frederik
Berger	Ruth
Berling	Peter
Stein	R. Conrad
Matthews	Susan R.
Tyers	Kathy
Pournelle	Jerry
P.	Hogan
Wismer	Don
Daley	Brian
Cherryh	C. J.
Margolin	Phillip
Goldberg	Leonard
TRUMAN	MARGARET
Morris	Willie
Dudgeon	Piers
Crawford	Marion
Cox	Josephine
Addis	Faith
Fitzgerald	F. Scott
Backer	Sara
Nix	Garth
Milne	B. Lumsden
Plisson	Philip
Siegel	Jan
Irving	Washington
Guisewite	Cathy
Schulz	Charles M.
GUIN	URSULA K. LE
Cooper	Susan
Breathed	Berkeley
Stern	Alison
Lehmann	Chrstine
Pedrolo	Manuel de
Alonso	Manuel L
Espinaus	Josep Maria
STILLMAN	DEANNE
Levine	Laura
Barrett	G. C.
Razzi	Jim
Atcott	Louisa M.
Ingoglia	Gina
Collodi	Carlos
Whitney	P. L.
Mackler	Carolyn
Gunn	Robin Jones
Macomber	Debbie
FRIEDMAN	STEVE
Hissey	Jane
Elementary	First Grade Students of H. Byron Masterson
Landon	Margaret
Baggott	Julianna
Boese	Alex
Garrison	Webb
MCCAFFERTY	MEGAN
Davis	Jill
Purdy	Charles
Johnson	Greg
Snow	Jonathan
Thompson	Sylvia
Paterson	Aileen
Rice	Molly
Ignatius	David
PEARSON	ALLISON
Tropper	Jonathan
Colgan	Jenny
Hopkins	Cathy
Miller	Melissa
Chauncey	Katherine B.
Foreman	George
Editors	Betty Crocker
Ed	Grange Books
Bly	Robert W.
Strandquist	Robert
Moran	Victoria
Gandy	Debrena Jackson
Warner	Sally
Jones	Daniel
Freiman	Kate
Carle	Eric
Redding	Stan
McReynolds	Glenna
Lowell	Elizabeth
Cohen	Ben
Medeiros	Teresa
Kingma	Daphne Rose
Spyri	Johanna
LEWIS	SHARI
Mayes	Frances
Crais	Robert
LUDINGTON-HOE	SUSAN
MacDonald	John D.
Shettles	Landrum B., Md
PARETSKY	SARA
Burnett	Frances H.
Wells	Robin
Erickson	Lynn
Sarno	John E.
Pacter	Trudi
Evans	Quinn Taylor
Taylor	Janelle
Tallant	Robert
Ibarra	Kattan
Hazzard	Shirley
PIERCE	TAMORA
Trotman	Felicity
Travis	Falcon
Lovitt	Chip
Grey	Harriet
Wilson	Robert A.
Parry	Owen
Perry	Michael
Yarbro	Chelsea Quinn
Patterson	Freeman
Gladwell	Malcolm
Krishnamurti	Jiddu
Dalrymple	William
Hoffman	Paul
Watts	Duncan J.
Singh	Sarina
Grewal	Royina
Faber	Inez McAlister
McDowell	Dottie
Beauman	Sally
Solotaroff	Paul
Singer	Peter
Ibsen	Henrik
Forster	E.M.
McGrady	John F.
Conroy	Pat
Lofts	Norah
Bakker	Robert T.
Shea	Suzanne Strempek
Dew	Robb Forman
Nylund	Eric
Kaye	Mary Margaret
Warden	Michael D.
Stanley	Thomas J.
Brown	Rosellen
Narayan	R.K.
Brown	George Mackay
Milligan	Spike
Paine	Thomas
Hill	A. J.
Sala	Sharon
Magazine	Guideposts
Watts	Marie
Richardson	Bill
BROWNE	JILL CONNER
O'Neal	Katherine
Belli	Giaconda
Meadon	R.
Gauez	Fernando Fernaun
Raich	Rosa Maria
Bulgakov	Mijail
Doblin	Alfred
Gray	Marianne
Anderson	Sherwood
Paulsen	Amy
Alvarez	Julia
REICH	CHRISTOPHER
Cantwell	Mary
Fatsis	Stefan
Kinsley	Michael
Listbader	Eric Van
Dadey	Debbie
Stanley	Charles, Dr
Carson	Rick
Clifford	Eth
PAULSEN	GARY
Cooney	Caroline B.
Ammaniti	Niccolo
MYERS	WALTER DEAN
O'DELL	SCOTT
Jenkins	Jerry
Shreve	Susan Richards
Marshall	James
Myers	Walter Dean
Nesbit	Edith
Sturgeon	Theodore
Veninga	Robert L.
Arnold	Janis
Bonner	Cindy
Crafts	Hannah
Grimsley	Jim
SIEGEL	ROBERT
SCARRY	RICHARD
Spillane	Mickey
Knowles	John
HALBERSTAM	DAVID
Ferguson	Will
OFF	CAROL
Lane	Anthony
Toole	John Kennedy
Blow	Richard
Beamer	Lisa
Suzuki	David
Connolly	John
Morris	J.M.
Lewis	Sara
Reichert	Mickey Zucker
Hogan	Lee
Miller	Judith
Pearson	T. R.
Schultheis	Bill
Gross	Kim Johnson
PUZO	MARIO
Witt	Wilbur
Lawrence	Iain
Greenberg	Martin H.
Wright	Peter
Stewart	Mary
Vidal	Gore
George	Elizabeth
Cochran	Molly
Collins	Jim
PIRSIG	ROBERT
McAllister	Troon
Mieville	China
Lee	Chang-Rae
BRADBY	TOM
Breslin	Jimmy
Haslett	Adam
Price	Victoria
Alexander	Lloyd
Rogers	D. E.
Robinson	Douglas R.
Black	Millenia
Fox	Laurie
Northcutt	Wendy
Mull	Martin
Carter	Rubin
Carey	Peter
Burke	Cinammon
Laker	Rosalind
McCullen	Mary
Squire-Buresh	Anne L.
Thayer	Nancy
Thompson	Hunter S.
Linamen	Karen Scalf
Marai	Sandor
Bennett	Alan
Blissett	Luther
Saavedra	Miguel De Cervantes
Schneider	Helga
Jamal	Salah
Rico	Santiago Alba
Tena	Luca de
Craze	Richard
Cercas	Javier
Arsan	Emmanuelle
Bucay	Jorge
Moix	Terenci
Etxebarria	Lucia
Burke	Delta
Johnston	Michael
Pike	Christopher
Simpson	Robert
Martin	Michael A.
Jarman	Heather
III	David R. George
Garton	Ray
Burke	Jan
Laing	Ed
Kahn	A. Michael
Green	Christine
Nordan	Lewis
Diehl	William
Fenton	Julia
Brady	Vicki A.
Davidson	Diane Mott
DOBSON	LINDA
Barnes	Bob
Allen	Marvin
Hobbie	Douglas
Gower	Iris
Sher	Antony
Jimenez	Juan Ramon
Jacobs	A.J.
Harris	Marvin
Marinoff	Lou
Paulos	John Allen
Tamaro	Susana
Welch	Jack
Press	Conari
III	Andre Dubus
Fehlau	Ria
Shales	Tom
Goldsborough	Robert
CRAIS	ROBERT
Blake	Jennifer
Pavord	Anna
Perry	S.D.
Straley	John
Bell	Julia
Larkin	Philip
Munsch	Robert N.
Quivers	Robin
Maclean	Norman
Hinton	S. E.
Gunther	John
Preston	Richard
Flank	Lenny
Adamson	Joy
Mahfouz	Naguib
Hui	Wei
Landis	Catherine
Ward	Amanda Eyre
Carson	Rachel
ADAMS	DOUGLAS
Hawks	Tony
Clarke	Lindsay
McQuillan	Karin
Thomson	Amy
Rowland	Laura Joh
STEPHENSON	NEAL
Kellogg	Marjorie B.
Baker	Kage
Clement-Davies	David
Pollack	Rachel
Jenkins	Emily
Cornelius	Mirika Mayo
Krulak	Victor H.
Lamanna	Mary Ann
Drosnin	Michael
Searles	John
Grace	Carol
Stone	Tom
Reynolds	Sheri
Bluh	Bonnie
TRIGIANI	ADRIANA
Murphy	Gloria
Shipman	Pat
Thomas	Donald
Freedman	Benedict
RICE	LUANNE
Berg	Elizabeth
Robinson	Roxana
Scott	Willard
Graham	Laurie
Leclaire	Anne D.
Hall	Parnell
Anderson	Catherine
Rivers	Nikki
Schulze	Dallas
Jenson	Muriel
Craig	Emma
Pearl	Nancy
Winton	Tim
Gautreaux	Tim
Fergus	Jim
Robinson	Randall
Marrs	Jim
Abbott	Edwin A.
Henry	O.
Hogan	James P.
Weible	Wayne
Cela	Camilo Jose
Harwood	Jeremy
Underwood	Jim
Cleage	Pearl
Morgan	Marlo
Meier	Gary
Hillen	Ernest
Madden	Deirdre
Lawrence	D.H.
Braam	Stella
DeLaney	Frank
Bieg	Hartmut
Pierce	Barbara
McCall	Dinah
Krahn	Betina
Small	Bertrice
Love	Kathy
Plumley	Lisa
London	Cait
Baratz-Logsted	Lauren
Gottlieb	Annie
Thompson	Vicki Lewis
Johnston	Tony
Munro	Ken
Parkhurst	Liz Smith
King	Thomas
Schneider	Hansjeirg
Strauss	Botho
Burkart	Erika
Moltke	Freya von
Delau	Reinhard
Schneider	Hansjaurg
Viragh	Christina
Wirz	Jacques
Meeks	Linda Brower
Lukas	Paul
CAPRA	FRITJOF
Kelman	Suanne
Seabrook	John
Tiger	Lionel
Niedzviecki	Hal
Becker	Ernest
Allen	Woody
Burton	Tim
Moss	Steve
Lott	Tim
Cain	James M.
HAMMETT	DASHIELL
Anastas	Benjamin
Saramago	Jose
Zipes	Jack
Nersesian	Arthur
Kirn	Walter
Henke	Roxanne
Staub	Wendy Corsi
Piven	Joshua
Williamson	Hugh Ross
Ribarich	Cindy
Lessard	Bill
Schechter	Harold
Adkins	Lesley
Gibson	Ian
Bondeson	Jan
Stallman	Richard M.
Bullard	Vaughn
Gentle	Mary
Hazel	Philip
O'BRIEN	TIM
Williams	Stephen
Perrin	Noel
Angier	Natalie
King	Laurie R.
Lessig	Lawrence
Everitt	Anthony
Nelson	Michael J.
KENDRICK	STEPHEN
Kennedy	Randall
Morton	Rochelle
Kelly	Jeff
Lynch	Thomas
King	Larry L
MACINTYRE	BEN
Friedman	David M.
Rilly	Cheryl
Hagberg	David
Price	Eugenia
Crescenzo	Luciano De
Burns	Edward McNall
Alter	Steven
Patier	Xavier
Serguine	Jacques
Schneider	Helge
Desai	Anita
Taylor	Gladys
Kinsella	W. P.
Nash	Bruce
Vandevelde	Vivian
BOWEN	GAIL
Kafka	Franz
Zipes	Jack David
Martin	George R.R.
Martin	George R. R.
MARTIN	GEORGE R.R.
Koja	Kathe
Lansky	Doug
Krantz	Judith
Henrick	Richard
Kingsley	Johanna
Notaro	Laurie
Caldwell	Taylor
Cameron	Julia
Griffin	Mark
Powers	Elizabeth
Perrotta	Louise
Cooper	Sue Ellen
Rohr	Richard
Kincaid	Jamaica
Fleischman	Paul
Livesey	Margot
HANAUER	CATHI
Moorman	Margaret
Ali	Monica
BERG	ELIZABETH
Fowler	Karen Joy
Sparks	Micah
Winston	Lolly
MINOT	SUSAN
Allen	Charlotte Vale
Galeano	Eduardo H.
Law	Janice
Hawkes	Judith
Jennings	James
Baudrillard	Jean
Schwartz	Alvin
Burgess	Melvin
Walsch	Neale Donald
JAMES	P.D.
Peery	Janet
Alexander	Robert
Fisher	Antwone Quenton
Chappell	Fred
MARQUEZ	GABRIEL GARCIA
Park	Frances
Gordon	Caroline
Zahn	Timothy
O'Cork	Shannon
Kirk	Larry
Scarfe	Gerald
Bell	Steve
Bryant	Mark
Goffe	Toni
Stickland	Henrietta
Rai	Milan
Sebald	W G
Kipling	Rudyard
Wagstaff	Mandy
Liedloff	Jean
Self	Will
Lanchester	John
STEVENS	JOHN
Pressfield	Steven
Hillier	B.B.
Moore	Lorrie
Day	Marlene
Klein	Robin
Finn	David
Cohen	Cafi
Moore	Raymond S.
Palladino	Lucy Jo
Dobson	Linda
Silva	Daniel
Adams	Robert
Turtledove	Harry
WEIS	MARGARET
TEVIS	WALTER
Wangerin	Walter
Shute	Nevil
Black	Conrad
Aldiss	Brian
Tevis	Walter
Niven	Jennifer
Fowler	Christopher
HAWKING	STEPHEN
Macarthur	Brian
Knaak	Richard A.
Wouk	Herman
Hugo	Victor
Hood	Daniel
Kiesow	Ulrich
Hamilton	Peter F.
Pascoe	Irene M.
Koss	Amy Goldman
Drake	David
Barron	Stephanie
Hewitt	William W.
Eliade	Mircea
Wyndham	John
Boyd	William
Cohen	J.M.
Whitten	D. G. A.
Moore	Wilfred George
Nietzsche	Friedrich
Roberts	A.R.R.R.
Stewart	Leighton
Mondey	David
Roffey	Monique
Blexley	Peter
Gardens	Better Homes and
Cole	Brian
Griffith	D.
Holland	Tom
Bichler	Albert
Remains	Jill
Davis	Natalie Zemon
KAUFFMAN	DONNA
Ephron	Nora
Friday	Nancy
Quick	Amanda
Steinem	Gloria
Carey	Lisa
BRADFORD	BARBARA TAYLOR
Rock	Joanne
Rathbone	Andy
Bennett	William J.
Parrish	Richard
Bullock	Alan
Ramgobin	Mewa
IVINS	MOLLY
McNeil	Legs
Baker	Stephen
Withey	Lynne
Josephus	Flavius
Barnes	Julian
HAILEY	ARTHUR
Didion	Joan
Gitlin	Todd
Fraser	Steve
Postman	Neil
Halberstam	David
Robertson	Pat
DUMAS	FIROOZEH
Pilcher	Rosamunde
Schine	Cathleen
Prose	Francine
Dietrich	William
Jensen	Ruby
Derbyshire	John
Hanh	Thich Nhat
Spinelli	Jerry
Seranella	Barbara
Blanchard	Alice
West	Tracey
George	Margaret
Begley	Louis
Arnim	Elizabeth von
Tuttle	Cameron
Parker	T. Jefferson
Austen	Mary
